NO sprites/redbrick.xpm
SO sprites/greystone.xpm
WE sprites/mossy.xpm
EA sprites/eagle.xpm

F 220,100,0
C 225,30,0

1111111111111111111111111
1000000000000000000000001
1000000001110000000000001
1000000001 1000000W000001
1000000001110000000000001
1000000000000000000111001
10000000000000000001 1001
1111111111111111111111111
